-                                                                                                      -
-     -                                                                                                -
-            -              -                                                                          -
--                                                                                                     -
-            --                                                                                        -
-                             -                                                                        -
--                       ---                                                                           -
-                                                                                                      -
-    **             ----     ---                                                                       -
-             ***                                                                                      -
--                                                                                                     -
-                         --                                                                           -
-             ******                                                                                   -
-                                                                                                      -
-                                                                                                      -
-      ---                                                                                             -
-                                                                                                      -
-                    ---                                                                               -
-                                                                                                      -
-                         -   P                                                                        -
-                            --                                                                        -
-                                                                                                      -
-                                                                                                      -
-     -                                                                                                -
-            -              -                                                                          -
--                                                                                                     -
-            --                                                                                        -
-                             -                                                                        -
--                       ---                                                                           -
-                                                                                                      -
-    **             ----     ---                                                                       -
-             ***                                                                                      -
--                                                                                                     -
-                         --                                                                           -
-             ******                                                                                   -
-                                                                                                      -
-                                                                                                      -
-      ---                                                                                             -
-                                                                                                      -
-                    ---                                                                               -
-                                                                                                      -
-                         -   P                                                                        -
--------------------------------------------------------------------------------------------------------
##################################                                                                     -
##################################                                                                     -