-                                - 
-                                -
-                                -
-                                -
-                                -
-                                -
-                               P-
-                            -----
-                          - ****-
-                          *     -
-                        -       -
-                        *       -
-                     -          -
-                     *          -
-                  -             -
-               -  *             -
-               *                -
-           -                    -
-           *                    -
-        -                       -
-        *                       -
-    -                           -
--   *                           -
##################################