-                                -
-   --                           -
--  -----_                       -
-   -    *                       -
-  --                            -
-   -                            -
--  -    -                       -
-   -    *                       -
-  --                            -
-   -                            -
--  -    -                       -
-   -    *                       -
-  --                            -
-   -                            -
--  -    -                       -
-   -    *                       -
-  --                            -
-   -    -------------------------
--  -                            -
-   -                            -
-  --     *     *      **     P  -
-   -  ---------------------------
--  -                            -
##################################