                                  
-                                -
-                                -
-                                -
-                                -
-                                -
-                                -
-                                -
-                                -
-                                -
-                                -
-                                -
-                                -
-                                -
-                                -
-                                -
-                                -
-                                -
-                                -
-                                -
-                                -
-                            D   -
----------------------------------
##################################